                                                              
####          ####   ####          ####  ####          ####   
#..###      ###..#   #..###      ###..#  #..###      ###..#   
#....########....#   #....########....#  #....########....#   
#####........#####   #####........#####  #####........#####   
    ##......##           ##......##          ##......##       
     #......#             #......#            #......#        
     #......#             #......#            #......#        
     #......#             #......#            #......#        
     #......#             #......#            #......#        
   ###......###         ###......###        ###......###      
####.#......#.####   ####.#......#.####  ####.#......#.####   
#..##........##..#   #..##........##..#  #..##........##..#   
#................#   #................#  #................#   
#..############..#####..############..####..############..####
#..#          #.........#          #........#          #.....#
#..#          #.........#          #........#          #.....#
#..###      ###..#####..###      ###..####..###      ###..####
#....########....#   #....########....#  #....########....#   
#####........#####   #####........#####  #####........#####   
    ##......##           ##......##          ##......##       
     #......#             #......#            #......#        
     #......#             #......#            #......#        
     #......#             #......#            #......#        
     #......#             #......#            #......#        
   ###......###         ###......###        ###......###      
####.#......#.####   ####.#......#.####  ####.#......#.####   
#..##........##..#   #..##........##..#  #..##........##..#   
#................#   #................#  #................#   
##################   ##################  ##################   
